barrage	keyword
冲锋枪和M4比哪个好？	大类枪
AK 好用还是M4好用？	大类枪
M4没有屁股不好用吧	大类枪
M4好用	大类枪
M4好用吗？	大类枪
m4后座大吗？	大类枪
有没有跟我一样只会玩AK的m416不会玩	大类枪
m4阔以	大类枪
M4是我最喜欢的一把枪	大类枪
QBZ步枪还是M416哪个好	大类枪
m4稳了	大类枪
有没有人和我一样M4贼强，其他枪不行的	大类枪
M4爆头无敌	大类枪
M4在手天下我有	大类枪
我喜欢玩M4，玩别的枪一般	大类枪
堵桥死的快	行为6-封路
现在还有必要堵桥？	行为6-封路
几岁了 ？还堵桥	行为6-封路
堵桥得看是谁啦，菜鸡堵桥就是搞笑	行为6-封路
堵桥狂魔	行为6-封路
堵桥可能就是肉靶子	行为6-封路
堵桥要加上几辆车	行为6-封路
....人体描边	行为10-菜
人体描边	行为10-菜
描边66666666	行为10-菜
描边nb	行为10-菜
人体描边已石锤	行为10-菜
人体描边大法	行为10-菜
人体描边嘎嘎嘎	行为10-菜
人体描边大师已上线	行为10-菜
人体描边挂	行为10-菜
描边枪法	行为10-菜
我要举报你。开了人体描边挂。	行为10-菜
终极描边大师	行为10-菜
这就是你们说的开挂  开的人体描边吗？ 还有什么话说	行为10-菜
人体描边挂  牛逼	行为10-菜
描边大神打出了夕阳红枪法	行为10-菜
描边大神	行为10-菜
万恶的伏地魔	行为2-苟
伏地魔我靠	行为2-苟
有伏地魔	行为2-苟
伏地魔	行为2-苟
还有一个伏地魔	行为2-苟
主播当过伏地魔吗	行为2-苟
mini 和 sks哪个好用？	大类枪
sks满配的时候很好用	大类枪
sks好用	大类枪
sks好用吗？	大类枪
sks阔以	大类枪
sks是我最喜欢的一把枪	大类枪
sks稳	大类枪
sks爆头无敌	大类枪
AK和冲锋枪比哪个好	大类枪
真正的拍手AK，就留一发哦	大类枪
我最怕那个AK	大类枪
AK怎么压枪有什么技巧吗	大类枪
我贼喜欢那款黄金ak	大类枪
AK就是我玩这款游戏的弱点	大类枪
大家喜欢用AK还是用M4？	大类枪
AK 好用还是M4好用？	大类枪
AK近战很强，远程稳定性不好	大类枪
AK在决赛圈爆头无敌	大类枪
有没有人和我一样AK贼强，其他枪不行的	大类枪
AK在近战就是神	大类枪
AK伤害不是超级高吗	大类枪
ak后坐力太大	大类枪
不玩ak？？？	大类枪
ak爆头好用	大类枪
手游ak最稳	大类枪
用AK大头贼舒服	大类枪
Ak系列打生化疼	大类枪
ak要扫射才好	大类枪
ak狂扫	大类枪
ak近战无敌啊	大类枪
一直不知道吃止痛药和喝饮料的区别	药品
刚玩时都不知道止痛药可以回血	药品
到底止痛药和饮料啥区别呢	药品
红点好用还是全息好用	附加武器
你们习惯用红点还是用全息	附加武器
一般红点和全息怎么选择呢，有什么技巧吗	附加武器
主播，你喜欢用全息还是红点	附加武器
是不是对高手来说，红点都没有机瞄好用	附加武器
有了红点近战无所畏惧	附加武器
感觉红点没有全息好用	附加武器
红点耶	附加武器
红点好用还是全息好用	附加武器
你们习惯用红点还是用全息	附加武器
一般红点和全息怎么选择呢，有什么技巧吗	附加武器
主播，你喜欢用全息还是红点	附加武器
是不是对高手来说，全息都没有机瞄好用	附加武器
全息耶	附加武器
近战是不是全息比四倍镜好多了？	附加武器
有了全息近战无所畏惧	附加武器
感觉全息没有红点好用	附加武器
怎么跳伞才能比较快落地呢？	行为11-跳伞
我赌5块落地成盒	行为11-跳伞
不要落地成盒了！！！！	行为11-跳伞
这把能吃鸡吗	行为11-跳伞
我赌你这把落地成盒	行为11-跳伞
落地成盒挂	行为11-跳伞
就喜欢看你落地成盒	行为11-跳伞
跳伞有什么技巧吗？为什么我每次都比人家落地晚	行为11-跳伞
主播可以说下跳伞的艺术吗	行为11-跳伞
跳伞有什么艺术吗	行为11-跳伞
如何优雅地跳伞才不会落地成盒	行为11-跳伞
练习跳伞哪家强？	行为11-跳伞
可以直播下如何跳伞直接摔死吗	行为11-跳伞
一直觉得舔空投太容易死了	大类空投
感觉拿空投还不如抓快递员	大类空投
如果决定拿空投，是不是一般要先放烟雾弹？	大类空投
空投狂魔	大类空投
空投！空投！ 危险！危险！	大类空投
每次看到三级甲都莫名激动	防具
遇到高手有三级甲也没用，人家直接爆头	防具
三级甲666	防具
三级甲，我喜欢	防具
好像有个三级甲在那边	防具
关键时刻就靠三极甲救命	防具
厉害的话，宁为玉碎，也别穿甲	防具
有三极甲被爆头也是一枪	防具
现在awm是不是可以一枪打穿二级甲？	防具
98k是不是可以一枪打穿二级甲？	防具
厉害的话，宁为玉碎，也别穿甲	防具
awm打1级甲是不是一枪就可以了？	防具
厉害的话，宁为玉碎，也别穿甲	防具
awm打二级甲是不是一枪就可以？	大类枪
可以表演下机瞄AWM吗	大类枪
就喜欢看你玩AWM	大类枪
有AWM的话就稳了	大类枪
awm满配贼强	大类枪
AWM近战就没啥用了	大类枪
awm爆头是不是可以一枪跪？	大类枪
awm爆头几枪over？	大类枪
新版本AWM是不是可以打穿三极甲？	大类枪
现在AWM是不是可以一枪打穿二级甲？	大类枪
AWM稳不稳？	大类枪
98k打一级甲是不是一枪就可以了	大类枪
就喜欢看你玩98K	大类枪
98k这把枪挺好看的	大类枪
开黑吗？我98k贼厉害	大类枪
想看98k	大类枪
不拿98k取消订阅	大类枪
98K伤害爆炸	大类枪
98k和M24哪个好用？	大类枪
除了AWM，就是98k和M24了	大类枪
秀一把98K可好	大类枪
有没有枪屁股差别很大吗	附加武器
枪屁股是稳定性的灵魂所在	附加武器
枪屁股和人屁股一样重要，下盘要稳	附加武器
没有枪屁股会很漂	附加武器
那边好像有个枪屁股	附加武器
枪托啊	附加武器
枪托不要吗	附加武器
可以玩一玩带枪托的枪吗	附加武器
别用枪托，增加难度	附加武器
那边有枪托	附加武器
大家觉得哪个握把好用一点	附加武器
主播，哪个握把好用一点？	附加武器
各位亲，哪个握把好用	附加武器
有没有大神告诉我哪个握把好用？	附加武器
垂直握把、拇指握把、直角握把哪个好用？	附加武器
根据经验介绍下，垂直握把适用于远距离单点，直角握把适用于中近距离扫射，拇指握把综合性很强	附加武器
像sks、mini装什么握把好呢	附加武器
步枪装什么握把好呢，比如M4？	附加武器
个人觉得，还是拇指握把给力	附加武器
论一个独狼的自我修养	身份3
独狼不苟活？ 哈哈哈	身份3
如果自己变成独狼， 要怎么打？	身份3
主播，如果不小心成为独狼，要怎么吃鸡	身份3
各位大神。如果不小心成为独狼，要怎么吃鸡	身份3
独狼还是选择下一局吧	身份3
机瞄猛男	行为12-开枪
机瞄真男人	行为12-开枪
机瞄才是真男人	行为12-开枪
怎么才能练一手好机瞄？	行为12-开枪
大神们，机瞄怎么练？	行为12-开枪
主播的机瞄什么怎么练的	行为12-开枪
一直不知道吃止痛药和喝饮料的区别	药品
刚玩时都不知道喝饮料可以回血	药品
到底止痛药和饮料啥区别呢	药品
红牛饮料，充满能量	药品
吼吼！大菠萝	大类枪
大菠萝压枪容易	大类枪
大菠萝只有趴着才稳，一般情况下还没ak好用，特别晃	大类枪
大菠萝没用	大类枪
大菠萝贼强！！！！	大类枪
我怕每次拿了大菠萝都要死一片的。。。。。不是我死就是对面死	大类枪
我手持大菠萝没怕过谁	大类枪
开黑吗，我大菠萝教你做人	大类枪
万里送快递	行为6-快递
准备好送快递	行为6-快递
千里快递	行为6-快递
又是快递到了	行为6-快递
不是一般的好快递员	行为6-快递
如何成为一名合格快递员	行为6-快递
论一名优秀快递员的自我修养	行为6-快递
敬业的快递员	行为6-快递
王牌快递员	行为6-快递
快递已在路上，请准备验收	行为6-快递
快递到了，请查收	行为6-快递
天天送快递	行为6-快递
喜闻乐见送快递	行为6-快递
快递即将送达	行为6-快递
五星好评快递员	行为6-快递
送快递去啦	行为6-快递
您的快递到了请注意查收 记得给好评哦	行为6-快递
快递小哥的一万种死法	行为6-快递
快递及时到位	行为6-快递
日常送快递	行为6-快递
一波快递送到	行为6-快递
快递已上线	行为6-快递
快递小哥迫不及待	行为6-快递
亲...您快递正在配送中。。。。请主要查收噢。。	行为6-快递
滴滴 快递	行为6-快递
满分快递来了	行为6-快递
快递是什么意思？	行为6-快递
咚咚咚，快递来啦	行为6-快递
咚咚咚 ，快递来啦，咚咚咚请签收。	行为6-快递
快递送上家  礼轻情意重	行为6-快递
极速快递！	行为6-快递
盒子王即将赶到	行为6-快递
跨省最快八小时 跨越快递	行为6-快递
主播可能开的是落地成盒挂	行为6-快递
这局是落地成盒？	行为6-快递
如何优雅地落地成盒？	行为6-快递
我以为职业主播都不会落地成盒	行为6-快递
落地成盒很丢人	行为6-快递
这集我看过，落地成盒的	行为6-快递
千万不要落地成盒！！！	行为6-快递
不要落地成盒好不好？	行为6-快递
又落地成盒？	行为6-快递
有种挂叫落地成盒挂	行为6-快递
真正的技术就是落地成盒	行为6-快递
落地成盒挂	行为6-快递
落地成盒？	行为6-快递
老阴比哈哈哈	行为4-老阴逼
这是lyb	行为4-老阴逼
LYB的最高境界	行为4-老阴逼
如何成为一名高端lyb	行为4-老阴逼
LYB王者	行为4-老阴逼
lyb，服	行为4-老阴逼
老阴逼，太坏了	行为4-老阴逼
吉利服容易被针对	防具
非常喜欢穿吉利服	防具
你们喜欢哪套吉利服	防具
主播最喜欢哪个吉利服？	防具
没事别穿吉利服	防具
不要吉利服	防具
吉利服没用	防具
开黑吗，我一把手枪行走天下	大类枪
各位大神，手枪哪把好用	大类枪
主播能不能说下哪把手枪好用	大类枪
手枪打的好，老婆不用讨	大类枪
主播能用手枪杀一个吗？	大类枪
大家知道怎么使用双手枪吗？？？	大类枪
手枪在手，天下我有	大类枪
一把手枪横着走	大类枪
手枪近距离威力大	大类枪
手枪当狙击使，会怎样？	大类枪
往面前扔雷	投掷道具
扔雷就完事了	投掷道具
扔烟再扔雷	投掷道具
先扔雷啊	投掷道具
扔完就跑	投掷道具
封完烟就跑	行为6-封路
封烟掩护	行为6-封路
挑战一下s686吃鸡	大类枪
主播可以挑战一下s686吃鸡吗	大类枪
想看你玩s686	大类枪
科普下s686怎么玩可以吗	大类枪
s686怎么玩	大类枪
开镜直接瞄头	行为12-开枪
开镜技术不好别开镜	行为12-开枪
开镜速度。。。。。	行为12-开枪
可以表演下开镜爆头吗？	行为12-开枪
这队友菜的可以	行为10-菜
队友菜的一逼	行为10-菜
队友菜的抠脚哈哈哈	行为10-菜
队友菜的头疼啊	行为10-菜
就算是在怎么30杀，如果队友菜的抠脚，也还是输	行为10-菜
队友菜的跟个啥一样	行为10-菜
队友菜的真实	行为10-菜
队友菜没办法，这不能怪我们家宝宝	行为10-菜
队友菜！鉴定完毕！！	行为10-菜
队友太菜，拉枪线都不会	行为10-菜
队友菜鸡啊	行为10-菜
人才猪队友	行为10-菜
猪队友操作	行为10-菜
猪队友没办法	行为10-菜
不要让猪队友跟着	行为10-菜
猪队友，老年操作	行为10-菜
猪队友也不错，0距离快递	行为10-菜
猪队友 真是烂泥扶不上墙	行为10-菜
猪队友 带不动啊	行为10-菜
猪队友为什么不自雷	行为10-菜
怎么老是碰到猪队友啊	行为10-菜
猪队友我也是服了	行为10-菜
知道什么叫猪队友了	行为10-菜
如何做一名优秀的猪队友	行为10-菜
队友菜的吓人	行为10-菜
队友菜跟不上节奏	行为10-菜
一封战神，力挺	行为12-战神
无敌战神	行为12-战神
主播宝宝永远是我们的战神	行为12-战神
战神吕布到此	行为12-战神
实力战神	行为12-战神
战神模式	行为12-战神
不败战神？	行为12-战神
哪把冲锋枪好一点？	大类枪
冲锋枪的特点是“射的又快又稳”	大类枪
我喜欢玩冲锋枪，玩别的枪一般	大类枪
主播玩冲锋枪	大类枪
冲锋枪和M16比哪个好？	大类枪
步枪近战没冲锋枪好	大类枪
冲锋枪和M4比哪个好？	大类枪
有没有人和我一样冲锋枪贼强，其他枪不行的	大类枪
主播，可以用一把冲锋枪横闯江湖吗	大类枪
有哪个大神可以用一把冲锋枪横闯江湖的，带我	大类枪
用冲锋枪在城市打巷战贼爽	大类枪
冲锋枪近距离无敌	大类枪
冲锋枪压不住	大类枪
冲锋枪压的住	大类枪
玩把冲锋枪吧	大类枪
特种部队很多用冲锋枪，步枪太重，射的慢	大类枪
主播用冲锋枪贼6，和我一样	大类枪
卡斯科冲锋枪怎么样？好用吗	大类枪
二级包好看	背包
不用三级包，二级包最好看	背包
二级包能装多少东西？	背包
二级包轻一点跑的快	背包
二级包不要吗？	背包
我看到一个二级包	背包
有个二级包在那边地上	背包
三级包太大，容易暴露，建议不要	背包
三级包太重跑的慢	背包
宁要一级、二级包，不背三级大草包	背包
我看到一个三级包	背包
有个三级包在那边地上	背包
二级包好看，三级包太大	背包
不用三级包，二级包最好看，一级包好看	背包
三级包能装多少东西？	背包
一、二级包轻一点跑的快	背包
三级包不要吗？	背包
三级包好看	背包
背着三级包很像书呆子	背包
一级包好看	背包
不用二级，三级包，一级包最好看	背包
一级包能装多少东西？	背包
一级包轻一点跑的快	背包
一级包？serious？	背包
我看到一个一级包	背包
有个一级包在那边地上	背包
二级，三级包太大，容易暴露，建议不要	背包
宁要1级、2级包，不背三级大草包	背包
轰炸是随机的吗	行为7-炸
从来没有被炸死过，被炸死是啥感觉哈哈	行为7-炸
在轰炸区被炸死是不是可以买彩票了	行为7-炸
召唤轰炸	行为7-炸
有没有人和我一样在轰炸区被炸死过	行为7-炸
我问个问题，轰炸区炸哪里，哪里就一定有人，这句话有根据嘛？	行为7-炸
轰炸区赌命	行为7-炸
在车里可以防轰炸吗	行为7-炸
为啥轰炸区是颜色不一样，有时红有时黄	行为7-炸
轰炸区随便炸	行为7-炸
请做一个敢于直面轰炸区的汉子	行为7-炸
是不是装甲车能扛三次轰炸	行为7-炸
在开车时我被轰炸区炸死过	行为7-炸
大狙在手，天下我有	大类枪
主播习惯用哪一把大狙	大类枪
你们习惯用哪一把大狙	大类枪
喜欢看主播玩大狙	大类枪
无敌的小刀	近战武器
不吃鸡给你寄刀片	近战武器
刀都不拣？	近战武器
聚在一起拿刀砍	近战武器
一刀就死了	近战武器
平底锅拍他	近战武器
平底锅大战	近战武器
平底锅也太无敌了吧	近战武器
平底锅过分啦	近战武器
平底锅拍你	近战武器
平底锅可以煎蛋的	近战武器
你是不是瞧不起平底锅？	近战武器
平底锅挡了一枪	近战武器
我感觉还是玩平底锅好	近战武器
想扔个震爆弹抢人头	投掷道具
拿个震爆弹呀，当闪光弹	投掷道具
要这么多震爆弹干嘛	投掷道具
在现场，我是震爆弹	投掷道具
论 震爆弹的作用	投掷道具
这个震爆弹，好秀	投掷道具
空投烟雾弹	投掷道具
挑战烟雾弹吃鸡	投掷道具
天然烟雾弹了解一下	投掷道具
烟雾弹大战	投掷道具
被烟雾弹呛到了。。。	投掷道具
烟，手雷，燃烧瓶都是必备	投掷道具
把你的燃烧瓶给我放下	投掷道具
把燃烧瓶取出来去取暖	投掷道具
燃烧瓶能干掉你们	投掷道具
买燃烧瓶附赠打火机	投掷道具
拿燃烧瓶吧，芳心纵火犯	投掷道具
用屁股想，正常人不捡头盔？	头盔
拿头盔盖住雷，趴在头盔上就会无视伤害	头盔
三级军用头盔，三级军用护甲，	头盔
一级头挑战吃鸡吗/{yw	头盔
98K不能装补偿的/{lh	大类枪
还是看你玩98K过瘾	大类枪
98K重现江湖	大类枪
恭喜98K出狱	大类枪
够犀利的98K	大类枪
看着这个98K可以就让人生气。	大类枪
你已经不适合玩98K了！	大类枪
玩98K 立马关注一波	大类枪
玩98K 喜欢看98K	大类枪
我室友临死前想看你玩把98K	大类枪
我手把手教你打98K	大类枪
我喜欢看的98K又回来了	大类枪
想看你玩98K	大类枪
VSS伤害太低了	大类枪
牛逼你用VSS吃鸡啊	大类枪
vss都能吃鸡我就迷茫了	大类枪
VSS把敌人能打自闭	大类枪
VSS未免太穷了	大类枪
M16A4才是万能的枪，远近都是高效率的	大类枪
M416装上消音，感觉射速好快好快	大类枪
M416突击步枪	大类枪
我想知道M4和M416 有什么区别？？？	大类枪
m416单点好还是m4单点好	大类枪
哇，現在還有用M416的主播啊，	大类枪
AKM太飘	大类枪
AK两枪头就挂	大类枪
打猛男枪也是个狠人	大类枪
AKM 一枪 头	大类枪
能拿手枪就有意思了	大类枪
试一下手枪吃鸡。	大类枪
你玩的好  手枪都是爸爸	大类枪
玩吧手枪战吗	大类枪
左轮好难用	大类枪
其实左轮也不错吧	大类枪
你们不觉得SCARL用3倍比M4厉害点？	大类枪
我今天在训练场也发现2倍SCAR很好用	大类枪
大家知道雨林地图有scar吗	大类枪
有AWM真的可以为所欲为。、	大类枪
满血AWM一枪不倒	大类枪
我不喜欢awm 每次都是捡子弹就走	大类枪
Awm一颗子的真谛	大类枪
我AWM和对面一个AWM互相爆头了😂	大类枪
AWM照样吃不了🐔	大类枪
啥时来一把双AWM啊	大类枪
M24最大好处是不用带几发子弹	大类枪
主播M24和98k那个伤害高点？	大类枪
M24我挺喜欢的。就是打不准	大类枪
M24的多少米要抬枪？？？	大类枪
m24子弹飞行速度是不是比98k快	大类枪
我刚捡的M24 倒杯水回来就死了	大类枪
雪地图M24满地都是	大类枪
sks适合轻型握把	大类枪
沙漠sks不推荐用	大类枪
沙漠sks下坠特别严重	大类枪
uzi吃鸡	大类枪
uzi吃鸡很菜	大类枪
汤姆逊削的有点惨，没人用了。。	大类枪
汤姆逊打靶	大类枪
汤姆逊特别的逊	大类枪
我用M16是真的打不来近战……	大类枪
M16A4才是万能的枪，远近都是高效率的	大类枪
来一局平底锅？？	近战武器
平底锅好玩点	近战武器
玩平底锅，一锅掉一滴血	近战武器
平底锅吃鸡	近战武器
有本事用平底锅吃鸡	近战武器
平底锅是信仰。	近战武器
好想拿平底锅拍在沟里……同意的扣1	近战武器
多些手雷	投掷道具
手雷是信仰	投掷道具
有本事用手雷吃鸡	投掷道具
来一局手雷局	投掷道具
搞点烟雾弹	投掷道具
烟雾弹会卡	投掷道具
烟雾弹真的不会用	投掷道具
扔个显卡	投掷道具
一大堆烟雾弹卡屏去	投掷道具
烧显卡之术	投掷道具
烟雾弹:显卡攻击	投掷道具
挑战烟雾弹吃鸡	投掷道具
燃烧瓶是个好东西	投掷道具
打火机都没有怎么点燃烧瓶	投掷道具
燃烧瓶没多大用处	投掷道具
燃烧瓶 比手雷好玩	投掷道具
干个燃烧瓶	投掷道具
弄燃烧瓶	投掷道具
燃烧瓶可以 持续伤害的	投掷道具
我想看你打燃烧瓶	投掷道具
喷子的眼里比他厉害的都是G ，笑死了	身份9
喷子套路   杀人是挂，死了是菜	身份9
不行，人气一高就各种低智商喷子。受不了	身份9
喷子永远都有理由说你别搭理	身份9
喷子面前人人平等	身份9
喷子面前众生平等	身份9
我是喷子的爷爷	身份9
我是喷子，要怎么喷？	身份9
中国特色，喷子，理解就好	身份9
我是新来的喷子 是走程序还是直接喷？	身份9
小聪 打电话给我了 叫我出去嗨 （校长）	身份8
谭校长听了想打人	身份8
校长起步	身份8
年度请校长帮忙就稳了	身份8
好久不见校长了	身份8
老师，我要告诉校长	身份8
p城吃鸡太难了	身份7
P城执法官好久不见	身份7
P城执法官，遇人杀人，遇神杀神	身份7
暴虐食尸鬼	身份6
化身食尸鬼降临	身份6
化身食尸鬼，别人吃鸡他吃尸体	身份6
王思聪，别看了，你学不会的。	身份5
王思聪离开了直播。。。。。。。	身份5
王思聪快凉凉了	身份5
王思聪打职业比赛的	身份5
北京最帅的不是王思聪吗	身份5
说的是 王思聪	身份5
我摊牌了，我叫王思聪。	身份5
别的不多说 王思聪和我有买卖往来/{dg/{dg/{dg	身份5
河北王思聪，来来来抬一手。	身份5
我是王思聪，你号没了	身份5
别人是电竞科学家	身份4
电竞科学家	身份4
我是科学家，我在来狙击你的路上	身份4
绝地科学家	身份4
绝地科学家，八倍不屏息啊	身份4
科学家警告。	身份4
天才科学家	身份4
十个主播九个挂，还有一个科学家	身份4
一级防可以防老婆出轨吗	防具
有人统计过M4打一级防需要多少枪吗？	防具
一级防有啥用？	防具
宁为裸奔，不为一级防	防具
一级甲有几种？	防具
刚枪时就知道一级防有多菜了	防具
一级甲和二级甲区别大吗	防具
一级防可以防老婆出轨吗	防具
有人统计过M4打一级防需要多少枪吗？	防具
一级防有啥用？	防具
宁为裸奔，不为一级防	防具
一级甲有几种？	防具
刚枪时就知道一级防有多菜了	防具
一级甲和二级甲区别大吗	防具
一级防可以防老婆出轨吗	防具
有人统计过M4打一级防需要多少枪吗？	防具
一级防有啥用？	防具
宁为裸奔，不为一级防	防具
一级甲有几种？	防具
刚枪时就知道一级防有多菜了	防具
一级甲和二级甲区别大吗	防具
一级防可以防老婆出轨吗	防具
有人统计过M4打一级防需要多少枪吗？	防具
一级防有啥用？	防具
宁为裸奔，不为一级防	防具
一级甲有几种？	防具
刚枪时就知道一级防有多菜了	防具
一级甲和二级甲区别大吗	防具
军用二级甲和警用二级甲有区别吗	防具
各位兄弟，穿上二级甲就可以防出轨吗	防具
二级甲和三级甲的差距大吗？	防具
二级甲遇上AWM也就一枪	防具
有二级甲，不错	防具
我经常连个二级甲都搜不到	防具
二级甲看不到吗？	防具
军用二级甲和警用二级甲有区别吗	防具
各位兄弟，穿上二级甲就可以防出轨吗	防具
二级甲和三级甲的差距大吗？	防具
二级甲遇上AWM也就一枪	防具
有二级甲，不错	防具
我经常连个二级甲都搜不到	防具
二级甲看不到吗？	防具
军用二级甲和警用二级甲有区别吗	防具
各位兄弟，穿上二级甲就可以防出轨吗	防具
二级甲和三级甲的差距大吗？	防具
二级甲遇上AWM也就一枪	防具
有二级甲，不错	防具
我经常连个二级甲都搜不到	防具
二级甲看不到吗？	防具
军用二级甲和警用二级甲有区别吗	防具
各位兄弟，穿上二级甲就可以防出轨吗	防具
二级甲和三级甲的差距大吗？	防具
二级甲遇上AWM也就一枪	防具
有二级甲，不错	防具
我经常连个二级甲都搜不到	防具
二级甲看不到吗？	防具
三级甲在手，天下我有	防具
每次看到三级甲都莫名激动	防具
遇到高手有三级甲也没用，人家直接爆头	防具
三级甲666	防具
三级甲，我喜欢	防具
好像有个三级甲在那边	防具
关键时刻就靠三极甲救命	防具
厉害的话，宁为玉碎，也别穿甲	防具
有三极甲被爆头也是一枪	防具
三级甲在手，天下我有	防具
每次看到三级甲都莫名激动	防具
遇到高手有三级甲也没用，人家直接爆头	防具
三级甲666	防具
三级甲，我喜欢	防具
好像有个三级甲在那边	防具
关键时刻就靠三极甲救命	防具
厉害的话，宁为玉碎，也别穿甲	防具
有三极甲被爆头也是一枪	防具
三级甲在手，天下我有	防具
每次看到三级甲都莫名激动	防具
遇到高手有三级甲也没用，人家直接爆头	防具
三级甲666	防具
三级甲，我喜欢	防具
好像有个三级甲在那边	防具
关键时刻就靠三极甲救命	防具
厉害的话，宁为玉碎，也别穿甲	防具
有三极甲被爆头也是一枪	防具
绿色衣，绿色帽，绿色鞋。。。原谅套装	防具
草衣就是吉利服吗	防具
草衣在手，天下我有	防具
每次穿上草衣都死的很快	防具
主播穿一个青青的草衣吧	防具
从来没捡过草衣	防具
草衣都靠抢	防具
草衣一般在空投里面	防具
有人在房区搜到草衣吗	防具
在急救包可以增加在信号区的停留时间吗	药品
残血时队友只给姨妈巾怎么办？	药品
姨妈巾是指绷带还是急救包呢？	药品
有人在河里扔过急救包吗	药品
大包多囤几个嘛	药品
大包，多多益善	药品
各位队友多囤几个大包给主播	药品
有超级姨妈巾	药品
大包在手，再也不怕刚枪	药品
姨妈巾！！！	药品
打绷带可以增加信号时间吗	药品
姨妈巾没用	药品
姨妈巾别捡	药品
绷带捡了了也没用	药品
绷带没用？	药品
小学生问下为啥绷带叫姨妈巾	药品
有奖竞猜：血量超过多少不能用姨妈巾？	药品
小绷带是姨妈巾，那小包是什么	药品
好像很少遇到肾上腺素	药品
肾上腺素补的能量最多吗	药品
饮料和肾上腺素多多益善	药品
拿个补肾素	药品
主播，肾上腺素是不是补肾的	药品
各位胸弟，你们补肾用肾上腺素吗	药品
生物老湿说，肾上腺素能让人更具能量哟	药品
肾上腺素来一个	药品
来一针激素	药品
笔记本电脑！	药品
笔记本电脑拿了吗	药品
我最喜欢医疗箱	药品
感觉医疗箱不好找。。。	药品
医疗箱干嘛整的和电脑一样	药品
医疗箱是保命神器	药品
多给主播捡几个医疗箱	药品
笔记本用了直接满血吗	药品
医疗箱好还是急救包好	药品
我不捡可乐，可乐杀精	药品
可乐是什么？不是能量饮料吗？	药品
主播别喝可乐呀，杀精	药品
可乐和止痛药有什么区别？	药品
肥宅水现在是不是可以添加信号时间？	药品
肥仔水	药品
那是红牛不是可乐	药品
可乐不好，明明是红牛	药品
男人喝了红牛可以持久吗	药品
红牛就是能量饮料吗	药品
男人喝了红牛可以持久吗	药品
红牛会杀精吗	药品
红牛喝了可以增加在圈外的时间吗	药品
多喝几个红牛	药品
我不捡可乐，可乐杀精	药品
一直不知道喝饮料可以回血的	药品
那明明是肥仔水好吗	药品
红牛，男人持续的动力	药品
专业医疗兵	药品
在线培训医疗兵	药品
医疗兵在线教程	药品
论一名医疗兵的自我修养	药品
最佳医疗兵哈哈	药品
开个医院做大夫吧	药品
我的原则是，永不救人	药品
救人？宁我负天下人，休将天下人负我	药品
别救人，舔他的包	药品
别救，果断卖	药品
救人赶紧	药品
赶紧救人啊	药品
先别救人	药品
扔个烟雾弹再救人	药品
封烟救人	药品
打包来人	药品
宁为玉碎，绝不打包？	药品
打包时来人怎么办？	药品
如何避免打包时来人？	药品
趴下打包	药品
到安全的地方打包	药品
主播穿个骚骚的背心呗	防具
不要防弹衣，穿个背心能吃鸡吗？	防具
一个背心能横着走吗	防具
一个背心横行天下？	防具
我喜欢穿背心	防具
穿背心感觉好屌丝	防具
穿个背心好搞笑	防具
主播穿个背心呗	防具
我发现职业选手带的子弹都特别少	子弹类
子弹袋 收米	子弹类
子弹要多一点	子弹类
子弹每秒800米	子弹类
在急救包可以增加在信号区的停留时间吗	背包
残血时队友只给姨妈巾怎么办？	背包
姨妈巾是指绷带还是急救包呢？	背包
有人在河里扔过急救包吗	背包
大包多囤几个嘛	背包
大包，多多益善	背包
各位队友多囤几个大包给主播	背包
有超级姨妈巾	背包
大包在手，再也不怕刚枪	背包
姨妈巾！！！	背包
打绷带可以增加信号时间吗	背包
姨妈巾没用	背包
姨妈巾别捡	背包
绷带捡了了也没用	背包
绷带没用？	背包
小学生问下为啥绷带叫姨妈巾	背包
有奖竞猜：血量超过多少不能用姨妈巾？	背包
小绷带是姨妈巾，那小包是什么	背包
主播倍镜是习惯用红点还是全息	附加武器
你们喜欢3倍镜还是4倍镜	附加武器
不用倍镜啦，机瞄才考验真本事	附加武器
全用机瞄好了，有倍镜贼烦	附加武器
4倍镜连狙不好用	附加武器
别老用红点，远距离m4切高倍镜	附加武器
倍镜开镜调节成蓝色怎么搞的	附加武器
霸占M城高点	地点
M城的人接客了	地点
大战全在M城	地点
M城那个养老院位置。真的很肥 基本会出信号枪	地点
霸占M城高点	地点
M城的人接客了	地点
大战全在M城	地点
M城那个养老院位置。真的很肥 基本会出信号枪	地点
渔村好穷啊	地点
主播你可以在渔村蹲会	地点
就在这里苟吧	地点
我最喜欢在渔村埋伏	地点
渔村咸鱼？	地点
那我们去机场....旁边的小渔村	地点
我在机场高架一枪打死圣山的我说什么了，我骄傲了么	地点
我玩csgo一狙打到圣山我骄傲了？	地点
圣山，光明顶，龙景山哪个更高丫？	地点
从圣山绕过来 真的牛批	地点
我在圣山山顶打的	地点
军事基地刚枪？	地点
每次到军事基地都好害怕	地点
军事基地很肥	地点
听听军事基地有几个人	地点
多捡点信号弹，把车全打出来，其他地方的人就叫不了车	陆地载具
响度均衡打开，上车要关声音，不然什么都听不到，全是车声	陆地载具
是车先动手的	陆地载具
别把车打坏了，不然一会跑到累死	陆地载具
下车！快递	陆地载具
是车先动手的	陆地载具
驾驶不规范，行人两行泪	陆地载具
驾驶室的窗户可以打穿吗	陆地载具
可以，这个驾驶技术不错	陆地载具
驾驶证多少钱买的呀？	陆地载具
吉普后轮驱动	陆地载具
吉普目标大啊	陆地载具
暴怒的吉普车	陆地载具
开开吉普一撞	陆地载具
蹦蹦撞车无敌	陆地载具
蹦蹦就要打轮	陆地载具
蹦蹦质量真好	陆地载具
死亡三蹦子，要来了	陆地载具
三蹦子最难开	陆地载具
三蹦子真过瘾	陆地载具
找到个蹦蹦车怎么办	陆地载具
我最喜欢开蹦蹦	陆地载具
蹦蹦撞车无敌	陆地载具
蹦蹦就要打轮	陆地载具
蹦蹦质量真好	陆地载具
死亡三蹦子，要来了	陆地载具
三蹦子最难开	陆地载具
三蹦子真过瘾	陆地载具
桑塔纳跟保时捷4档速度是一样的吗	陆地载具
马路小流氓，还得桑塔纳	陆地载具
大屁股桑塔纳	陆地载具
无敌桑塔纳	陆地载具
多点汽油，多点燃烧瓶，多点手雷，专炸装甲车	陆地载具
汽油桶怎么杀人	陆地载具
汽油桶这样玩，在桶旁边放个饮料啥的，蹲着别人来捡了就打	陆地载具
一会儿别人打汽油桶你就笑了	陆地载具
有段时间没玩了，现在汽油桶很有用吗？？	陆地载具
汽油桶能打爆吗	陆地载具
汽油桶是干嘛的？	陆地载具
汽油桶炸不死人	陆地载具
直播骑摩托艇	海上载具
拿车撞一下摩托艇	海上载具
开快艇那空投啊	海上载具
疯狂摩托艇	海上载具
摩托艇体验。300一位	海上载具
下船太快撞死自己了 哈哈哈	海上载具
破船算了	海上载具
这个船是什么鬼？	海上载具
刷回来也有船呀	海上载具
船怎么过桥	海上载具
主播 我一点都不会玩 能带我上车舔盒子么 嘿嘿	行为1-舔
我想当舔狗 怎么上车	行为1-舔
含泪舔队友的包	行为1-舔
麻瓜队友，舔第一名	行为1-舔
杀队友舔他包	行为1-舔
厕所可以苟活一波	行为2-苟
苟一苟活到九十九	行为2-苟
苟和打野有啥区别	行为2-苟
队友又菜又苟啊~	行为2-苟
宁做枪下鬼，不为苟活人	行为2-苟
这是个水鬼挂	行为2-苟
跳河就成水鬼了	行为2-苟
水鬼不好当	行为2-苟
水鬼上岸	行为2-苟
死于水鬼	行为2-苟
这车跑贼慢	行为3-跑圈
跑吧，没子弹了	行为3-跑圈
跑毒饿了是不是还的吃装甲车呀	行为3-跑圈
月薪一千五请问开什么跑车有排面	行为3-跑圈
抢车快跑	行为3-跑圈
这个圈我玩过	行为3-跑圈
打个装甲车 决赛圈演戏	行为3-跑圈
我决赛圈都不敢开车	行为3-跑圈
车。带油！开进决赛圈！！！	行为3-跑圈
圈内打信号枪有车吗	行为3-跑圈
嘛小鸡，老阴逼恶心，现实见到他眼睛给他踢碎	行为4-老阴逼
没事我就去骂骂，嘛小鸡，老阴逼恶心	行为4-老阴逼
嘛杂，滚，老阴逼，恶心	行为4-老阴逼
嘛杂点灯，就是慈善，老阴逼恶心	行为4-老阴逼
看见老阴逼一次举报十次	行为4-老阴逼
带带老阴逼	行为4-老阴逼
白嫖头目，老阴比	行为4-老阴逼
白嫖之王老阴比	行为4-老阴逼
不懂老阴比的梗能不能别带节奏了	行为4-老阴逼
白嫖头子，老阴比	行为4-老阴逼
怎么打劫一辆装甲车？	行为5-收集装备
停车，打劫	行为5-收集装备
随机打劫读	行为5-收集装备
打劫一波就行了	行为5-收集装备
冲鸭冲鸭 打劫打劫都得死都得死	行为5-收集装备
打野贼六	行为5-收集装备
打野带飞全场？？	行为5-收集装备
我打野能手	行为5-收集装备
打野命苦	行为5-收集装备
打野发育	行为5-收集装备
队友打架 他搜房在	行为5-收集装备
辛辛苦苦搜房子送快递人家还嫌弃	行为5-收集装备
太谨慎了搜房子	行为5-收集装备
搜房子搜一年	行为5-收集装备
不满血搜房收米	行为5-收集装备
抢装备哈哈哈哈哈哈	行为5-收集装备
出绿抢装备	行为5-收集装备
:不抢装备	行为5-收集装备
去打架抢装备吧	行为5-收集装备
呵，向人家学学多抢抢装备（狗头保命）	行为5-收集装备
刚刚不打车就进房子了，非要狼	行为5-收集装备
进房子低头捡药？	行为5-收集装备
进房不打字 只刷花	行为5-收集装备
进房只发表情，严禁打字	行为5-收集装备
都进房啦 开门那	行为5-收集装备
收过路费	行为6-封路
钓鱼执法，留下过路费	行为6-封路
有没有人报销下路费	行为6-封路
这是大哥给的路费	行为6-封路
众筹过路费啦	行为6-封路
英勇投弹手	行为7-炸
英勇投弹手实锤	行为7-炸
亡灵投弹手	行为7-炸
灵魂投弹手	行为7-炸
投弹手冲鸭	行为7-炸
真能蹲点	行为8-蹲点
我先来蹲点	行为8-蹲点
蹲点炸你不是问题	行为8-蹲点
他们蹲点可以蹲一辈子	行为8-蹲点
点位都知道吧。玩多了知道哪个位置有人蹲点很正常吧	行为8-蹲点
好热闹啊，劝架去	行为9-劝架
头都没，还劝架	行为9-劝架
还有劝架这么一说的吗	行为9-劝架
劝架引起众怒	行为9-劝架
极限劝架	行为9-劝架
敢问施主是随缘枪法还是夕阳红枪法？	行为10-菜
夕阳红枪法 和我一样	行为10-菜
夕阳红枪法	行为10-菜
修脚师傅	行为10-菜
专业修脚	行为10-菜
刚刚修脚不是很好	行为10-菜
小心被修脚	行为10-菜
趴下人家能给你修脚	行为10-菜
修脚大师	行为10-菜
学渣落泪	行为10-菜
原来在你眼里我是个学渣吗	行为10-菜
学渣退出直播间	行为10-菜
学渣加油	行为10-菜
学渣下课了	行为10-菜
强行解释，掩饰尴尬的倒地	行为10-菜
下一次倒地已准备就绪	行为10-菜
倒地父子兵	行为10-菜
各种倒地队友	行为10-菜
被倒地的队友挡住了	行为10-菜
倒地的和他队友说楼上的是大哥，快走！	行为10-菜
倒地的一刻，弹幕如潮水般袭来	行为10-菜
倒地的不算伤害的	行为10-菜
对面倒地气死	行为10-菜
跑动的打得准，倒地的永远打不中	行为10-菜
我能喝一整瓶红酒/{xu 喝完直接倒地上而已	行为10-菜
在空中蹦哒了一下倒地	行为10-菜
倒地不能吃吗	行为10-菜
等一下你因为一滴血而倒地就不是这样说的	行为10-菜
人未倒地，已到界面	行为10-菜
说单排的，倒地的你去扶？？？？	行为10-菜
带妹届耻辱，刚进来就看你倒地。	行为10-菜
一声巨响繁华倒地而亡	行为10-菜
一头倒地	行为10-菜
这是倒地的 你小心	行为10-菜
安全区外倒地	行为10-菜
先倒地啊	行为10-菜
遇到大神你跟着 只能补倒地的，还不算人头，体验极差	行为10-菜
上树和树精选一样	行为10-树
狗急上树	行为10-树
猪上树了	行为10-树
用树档子弹啦	行为10-树
树精降临	行为10-树
靠树吃鸡，一苟到底	行为10-树
做个霸主	行为12-战神
学霸，机霸万岁	行为12-战神
我是霸王	行为12-战神
西楚霸王在此，谁敢放肆	行为12-战神
集中帝国兵力干大架	行为12-战神
帝国子弟兵	行为12-战神
帝国村霸，人人喊打	行为12-战神
背后有整个帝国为你撑腰	行为12-战神
帝国人民前来干架	行为12-战神
帝国领土你不能侵犯	行为12-战神
保卫帝国	行为12-战神
国服是神仙服	行为12-战神
什么时候练到弹无虚发那就是绝地的神仙哥哥卡	行为12-战神
都是神仙打架	行为12-战神
真的神仙	行为12-战神
遇见神仙了？	行为12-战神
怎么换服务器呀，亚服神仙多得离谱	行为12-战神
这神仙都打不过  上来两枪头	行为12-战神
。妈耶  这什么神仙节奏	行为12-战神
反向Q 赛神仙	行为12-战神
反向一Q日神仙	行为12-战神
我去 我还以为这是普通排位  这都是神仙打架	行为12-战神
这就是神仙打架。。。无敌	行为12-战神
神仙服。你惹不起！	行为12-战神
你是神仙吧 不睡觉	行为12-战神
估计这局神仙大战	行为12-战神
你是敢和神仙一较高下的男人	行为12-战神
只有高手才会被人喷神仙	行为12-战神
只有高手，才能当校长杀手	行为12-战神
顶级杀手变为校长杀手	行为12-战神
校长杀手上线	行为12-战神
校长杀手已开启	行为12-战神
ak爆头率75%😱😱😱	行为12-战神
爆头挂已开启	行为12-战神
爆头王上线，top1往边上考考	行为12-战神
想上就得多练，每天练3000爆头才能睡	行为12-战神
爆头全靠玄学	行为12-战神
爆头一击	行为12-战神
别问，问就是爆头	行为12-战神
见面爆头	行为12-战神
666移动靶爆头	行为12-战神
90％＋＋＋爆头率	行为12-战神
全是爆头	行为12-战神
这爆头就跟开了锁头一样。。	行为12-战神
这爆头有点狠	行为12-战神
作业是多少个爆头啊	行为12-战神
八倍的应该能爆头	行为12-战神
一枪爆头。	行为12-战神
瞬间爆头	行为12-战神
随缘爆头	行为12-战神
这枪法绝对职业级别的，移动爆头	行为12-战神
不动的话容易被爆头	行为12-战神
枪枪爆头怎么练的，	行为12-战神
一点一个爆头	行为12-战神
爆头全靠抖	行为12-战神
小心爆头	行为12-战神
藏的时候被爆头怎么办？	行为12-战神
近战这么强为啥要架枪？	行为12-开枪
不应该打架枪位	行为12-开枪
分工不明，那就不要架枪位都打突击协同	行为12-开枪
打架枪位就崩了	行为12-开枪
架枪有点弱的	行为12-开枪
。。。。身为架枪滞后位这枪法确实还换下来了	行为12-开枪
斯文 低调 有礼貌   架枪 报点 带着药 最好的CPT	行为12-开枪
真诚架枪	行为12-开枪
看屁股位 架枪位	行为12-开枪
是脏活累活位，断后看屁股架枪	行为12-开枪
主播是突击位置还是架枪位置	行为12-开枪
因为架枪，不打近战	行为12-开枪
有啥可惜的，架枪也能发光发热	行为12-开枪
这阵容谁是架枪位置	行为12-开枪
队友架枪。他在枪口下过	行为12-开枪
架枪的都死了。。	行为12-开枪
刷一个圈死一个架枪的/{gd	行为12-开枪
第一架枪手?	行为12-开枪
基本谁前点谁掏  后点补位置架枪	行为12-开枪
队友们注意架枪	行为12-开枪
该架枪的架枪，该突进的突进	行为12-开枪
4人突击组 2人后援组  2人架枪组	行为12-开枪
每次提前架枪有点厉害👍👍👍👍	行为12-开枪
人家只是每次提前架枪杀人。你们就说人家是挂	行为12-开枪
队友都不帮架枪的	行为12-开枪
你们应该一个架枪两个游泳！没分配	行为12-开枪
去捡吧，我给您架枪	行为12-开枪
找队友架枪	行为12-开枪
你们放心冲我在后面架枪	行为12-开枪
架枪关键的有实力	行为12-开枪
大家都要在同一平台上面，这样可以相互补枪	行为12-开枪
太怂的队友不敢上 补枪都不及时	行为12-开枪
毫无协同和补枪，次次到这个阶段就一个一个死。	行为12-开枪
之前MA4 几个人也是单兵作战，互相之间的协同补枪很差	行为12-开枪
人家都不补枪就你第一时间补	行为12-开枪
敌方卧底   疯狂补枪	行为12-开枪
补枪补到手累	行为12-开枪
喊个人跟你，可以补枪可以救	行为12-开枪
你看些新手都不知道几个人，直接冲脸上补枪	行为12-开枪
你倒在门口，他们也进不去补枪	行为12-开枪
鬼知道那个队友被补枪了	行为12-开枪
你是来拉枪线的	行为12-开枪
拉枪线很细节	行为12-开枪
多拉枪线，多换位置	行为12-开枪
快速拉枪线不完的要死	行为12-开枪
拉枪线走人	行为12-开枪
拉枪线是真的厉害	行为12-开枪
你可以拉枪线啊	行为12-开枪
拉枪线也不好打	行为12-开枪
来一波强袭	行为12-开枪
强袭不易，容易挂	行为12-开枪
强袭一波66666	行为12-开枪
这波强袭打得很稳	行为12-开枪
吃鸡稳如狗	行为12-开枪
吃鸡到后，应有尽有	行为12-开枪
把把吃鸡	行为12-开枪
吃鸡战神，杀人无数	行为12-开枪
不吃鸡不下播	行为12-开枪
刚枪吃鸡，完美无缺	行为12-开枪
有小姐姐打游戏么	身份1-妹子
比心小姐姐	身份1-妹子
可以跟小姐姐一起吃鸡吗	身份1-妹子
小姐姐说话挺可爱	身份1-妹子
被小姐姐勾住了	身份1-妹子
怪琼过分美丽小姐姐 ，阿尼哈撒哟~	身份1-妹子
好漂亮小姐姐	身份1-妹子
这小姐姐真好看	身份1-妹子
你好小姐姐	身份1-妹子
你还欠我一个小姐姐	身份1-妹子
小姐姐，我真崇拜你。	身份1-妹子
撩小姐姐的	身份1-妹子
被别的小姐姐勾住了	身份1-妹子
我去比心找小姐姐玩游戏/{hh	身份1-妹子
小姐姐声音好好听	身份1-妹子
这么漂亮的小姐姐 会打吗	身份1-妹子
心疼小姐姐	身份1-妹子
没有妹子，这鸡索然无味	身份1-妹子
妹子带吃鸡？	身份1-妹子
妹子 自闭了。。。	身份1-妹子
这个妹子好美	身份1-妹子
为什么会有妹子？	身份1-妹子
保镖会武功。神仙打架。还有演	身份2-队友
保佑你	身份2-队友
痛击我的队友保护对面敌人	身份2-队友
又来收保护费啦	身份2-队友
别太着急帮队友吧 保证自己生存先	身份2-队友
隐形守护者	身份2-队友
家的守护者 ，萨瓦迪卡~	身份2-队友
守护者的任务，站在高地狙击敌人，守护她一辈子.	身份2-队友
我就是正义的守护者	身份2-队友
守护在你身边	身份2-队友
四蛆兄弟演绎蛆的精髓	身份2-队友
四蛆兄弟吃鸡来一把	身份2-队友
四蛆兄弟，全体挂机	身份2-队友
奔跑吧，四蛆兄弟	身份2-队友
四排吃鸡来一把	身份2-队友
神奇四匣，欢乐吃鸡	身份2-队友
欢迎收看神奇四匣，绝命快递	身份2-队友
神奇四匣开黑搞笑时刻	身份2-队友
我觉得VSS不好用，主要就是打半天打不死	大类枪
VSS有卵用啊	大类枪
VSS还是阔以的，感觉射速很舒服	大类枪
整死用不来VSSS	大类枪
就只有刚开始跳下来才会用vector吧	大类枪
vector满配是什么样	大类枪
vector好用？	大类枪
垃圾vector	大类枪
有枪谁TM捡vector	大类枪
懂个锤子，vector是世界上最好用的枪	大类枪
我用M16是真的打不来近战……	大类枪
M16装上消音，让你感受不到射击	大类枪
刚开始玩的时候特喜欢捡m16	大类枪
m16,m4和m416 有什么区别？？？哪个好用点	大类枪
m16单点好用吗？跟m4单点比呢？	大类枪
M416突击步枪	大类枪
我想知道M4和M416 有什么区别？？？	大类枪
m416单点好还是m4单点好	大类枪
哇，現在還有用M416的主播啊，	大类枪
手枪打的好，老婆不用讨	大类枪
试一下手枪吃鸡。	大类枪
你玩的好  手枪都是爸爸	大类枪
玩吧手枪战吗	大类枪
大菠萝只有空投才有？	大类枪
听说大菠萝打车很爽？	大类枪
大菠萝跟车最配	大类枪
有人说大菠萝100发子弹是开挂哈哈哈哈	大类枪
我大菠萝100发就中了两发我队友都疯狂扣666	大类枪
这是我决赛圈大菠萝一打四吃鸡的地方	大类枪
大菠萝不好上子弹	大类枪
大菠萝 换弹是硬伤/{fe/{fe/{fe	大类枪
拿大菠萝换子弹太慢了	大类枪
大菠萝 打现在的防弹车特别舒服	大类枪
大菠萝 玩的稳的玩家 还是可怕的武器	大类枪
大菠萝换子弹太要命了	大类枪
大菠萝其实很吊的，前十发子弹都不飘的，但是用的人太少了	大类枪
大菠萝太几把猛了	大类枪
大菠萝在决赛圈。。。。。	大类枪
大菠萝不需要上子弹	大类枪
scar没什么卵用，刚开始捡捡还行	大类枪
scar得配消音	大类枪
SCAR蛮好用的	大类枪
喜欢用2倍scar	大类枪
喜欢3倍scar	大类枪
不喜欢SCAR	大类枪
垃圾scar	大类枪
相比于AWM我更喜欢m24	大类枪
AWM是真的爽	大类枪
AWM不好使	大类枪
单排的时候AWM无解	大类枪
AWM对于我来说就是一堆废铁	大类枪
m24枪杆太TM帅了	大类枪
M24加消音爽得一匹	大类枪
m24单排流批	大类枪
m24感觉比98K爽	大类枪
垃圾UMP	大类枪
UMP这种枪都有人用的吗	大类枪
主播能用UMP吃鸡？	大类枪
UMP贼j2难用	大类枪
菜鸡当然觉得UMP难用咯	大类枪
UMP大神有没有	大类枪
想看主播UMP吃鸡	大类枪
UMP能吃鸡？想多了吧	大类枪
有其他枪谁TM还用UMP	大类枪
哪怕是把vector也好呢	大类枪
UMP?想不开？	大类枪
听说UZI射速快，近战的时候很有用	大类枪
UZI射速快，遇见人直接一梭子很快就打没了	大类枪
远距离UZI约等于废铁	大类枪
UZI其实不差的，会玩的人不会用它对枪，UZI这种适合房区	大类枪
垃圾UZI，烂得一匹	大类枪
UZI一般吧，有更好的肯定不用它	大类枪
汤姆逊削的有点惨，没人用了。。	大类枪
汤姆逊打靶	大类枪
汤姆逊特别的逊	大类枪
汤姆逊？还不如vector	大类枪
垃圾汤姆逊	大类枪
亲，这边建议您把手中的汤姆逊扔掉	大类枪
讲真，冲锋枪里面就汤姆逊最垃圾了	大类枪
能用汤姆逊吃鸡吗	大类枪
冲锋枪适合近战，汤姆逊也没那么不堪	大类枪
汤姆逊还行	大类枪
没枪的时候汤姆逊还不是抢着捡	大类枪
垃圾UMP	大类枪
UMP这种枪都有人用的吗	大类枪
主播能用UMP吃鸡？	大类枪
UMP贼j2难用	大类枪
菜鸡当然觉得UMP难用咯	大类枪
UMP大神有没有	大类枪
想看主播UMP吃鸡	大类枪
UMP能吃鸡？想多了吧	大类枪
有其他枪谁TM还用UMP	大类枪
哪怕是把vector也好呢	大类枪
UMP?想不开？	大类枪
P1911建议扔掉	大类枪
这种枪能吃鸡？	大类枪
P92？开玩笑的吗	大类枪
不扔留着吃鸡？	大类枪
MK14，随便打哪，三枪一个	大类枪
为啥MK14没皮肤呢	大类枪
能拿到MK14的都是有缘人	大类枪
想看15倍MK14压枪	大类枪
MK14换子弹太慢	大类枪
mk14牛逼	大类枪
mini弹道直好嘛	大类枪
mini一枪头一枪甲也不死	大类枪
mini只适合单身贵族	大类枪
看不起mini吼	大类枪
mini装消音偷人好耍	大类枪
mini 准星恢复最快的  没有之一	大类枪
mini弹道不错的	大类枪
mini这枪一点也不强啊	大类枪
mini是真的稳，就是伤害感人了点	大类枪
mini伤害不行	大类枪
MK14换子弹真的慢	大类枪
mini威力不行	大类枪
mini威力太小了	大类枪
搞把mini秒人太爽	大类枪
mini要配2倍镜	大类枪
职业比赛，mini用的最多	大类枪
mini是欧洲联赛最强的枪	大类枪
感觉超过200米的距离也只有mini适合打移动靶	大类枪
mini没什么后坐力，挺好的	大类枪
补偿器mini是真的稳	大类枪
mini适合比赛，比赛没有那么多时间给你搜配件而且mini不吃配件	大类枪
s12建议扔掉	大类枪
s12垃圾枪，一点都不稳	大类枪
s12k子弹分布比s686广？	大类枪
能秀一把S1897吗	大类枪
S1897有个bug不用换弹能一直打？	大类枪
s1897的伤害永远是个迷	大类枪
信号枪在手，天下我有	大类枪
一般选择在哪开信号枪比较好	大类枪
我每次拿信号枪都死的很快	大类枪
捡到信号枪的几率是多大？	大类枪
玩了几千小时都没捡过信号枪	大类枪
信号枪怎么设置出来等	大类枪
信号枪是神仙召唤器	大类枪
感觉是有很多信号枪的样子	大类枪
你们没有玩过信号枪枪战吗？	大类枪
好久信号枪	大类枪
显卡攻击？	大类枪
玩自定义去，满地信号枪	大类枪
信号枪不要钱啦	大类枪
信号枪打人什么效果	大类枪
散弹爽，刺激	大类枪
散弹吃鸡给我看	大类枪
我室友老爱带把散弹枪带到最后跟人捉迷藏	大类枪
在啥情况下要保留散弹	大类枪
冲锋枪不无脑突脸怎么可能对得过长枪	大类枪
17年版本的职业比赛也是物资穷什么冲锋枪到处跑	大类枪
冲锋枪我选vector	大类枪
冲锋枪我选UZI	大类枪
冲锋枪肯定UMP9啊	大类枪
近战冲锋枪蛮好用的啊	大类枪
消音冲锋枪牛逼，哒哒哒~~~	大类枪
维克多伤害高，是所有冲锋枪里伤害最高的	大类枪
冲锋枪好啊，没步枪那么飘~	大类枪
冲锋枪唯一弱点就是打三级甲费劲	大类枪
M16垃圾枪	大类枪
主播，M16可以吃鸡吗	大类枪
秀下用下M16吃鸡哩？	大类枪
M16这把无敌烂枪怎么吃鸡？	大类枪
M16装上消音，让你感受不到射击	大类枪
刚开始玩的时候特喜欢捡m16	大类枪
m16,m4和m416 有什么区别？？？哪个好用点	大类枪
m16单点好用吗？跟m4单点比呢？	大类枪
约等于没用	大类枪
直接扔	大类枪
敢不敢用r18吃把鸡	大类枪
机枪吃不了鸡	大类枪
机枪不好用	大类枪
大狙要果断，练瞬狙	大类枪
雪地大狙特别多	大类枪
大狙不是一般人能玩的	大类枪
菜鸡就不要玩大狙了，浪费	大类枪
看大狙会爽很多啊	大类枪
求你了，打一把大狙吧	大类枪
拿大狙你就的死，没理由	大类枪
单四还是连狙好，大狙杀了难补人头	大类枪
大狙适合单排	大类枪
大狙看着就很爽	大类枪
挂在身上枪杆老长了	大类枪
秀一下12k？	大类枪
S12K是真的猛啊	大类枪
主播会12k吃鸡吗	大类枪
12k牛逼	大类枪
m249有消音的位置吗	大类枪
m249好堵桥？	大类枪
m249近战无敌	大类枪
要是四个M249一起开火是一种什么样的体验啊？	大类枪
有玩弩箭玩得6的吗	大类枪
弩箭吃鸡是什么样子	大类枪
没见过弩箭吃鸡的	大类枪
主播能用弩箭吃一把鸡吗	大类枪
弓箭吃鸡刷虎牙一号	大类枪
